R...X.....
.XX.X.XX..
....X...X.
.XX...X...
...XX.X...
X.....X.X.
..XXX...X.
.....X....
.XXX...XX.
......X..G

